   R        1024 720
        NO           ./textures/bluestone.xpm
SO         ./textures/greystone.xpm
WE ./textures/redbrick.xpm
               EA ./textures/wood.xpm
S    ./textures/barrel.xpm
F   150,    150,    150
C 225, 255, 255

11111111  
10000001 
10000001
1000000111
10000001 
10000001 
11111111   
    11
    1
11111111   
10000001  
10000001 
100000011
1000N001 
10000001
11111111 
