   R        1024 720
        NO           ./textures/bluestone.xpm
SO         ./textures/greystone.xpm
WE ./textures/redbrick.xpm
               EA ./textures/wood.xpm
S    ./textures/barrel.xpm
F   150,    150,    150
C 225, 255, 255

1   11111111111111111
11   1000000000000001
101   100000111000001
1001   100000000E0001
10001   1000000000001
100001   100000000001
1111111   11111111111
