   R        1024 720
        NO           ./textures/bluestone.xpm
SO         ./textures/greystone.xpm
WE ./textures/redbrick.xpm
               EA ./textures/wood.xpm
S    ./textures/barrel.xpm
F   150,    150,    150
C 225, 255, 255

11  1111111111111111111
111  110000000000000011
1011  11100000111000001
10011  11100000000E0001
100011  111000000000001
1000011  11000000000011
11111111  11111111111111
