   R        1024 720
        NO           ./textures/bluestone.xpm
SO         ./textures/greystone.xpm
WE ./textures/redbrick.xpm
               EA ./textures/wood.xpm
S    ./textures/barrel.xpm
F   150,    150,    150
C 225, 255, 255

11111111          11111111
10000001111111111110000001
10000000000000000000000001
10000000000000000011111111
1000N00000000000001
1000000111111111111
11111111
