R	1000	500
SO ./textures/redbrick.xpm
WE ./textures/wood.xpm
EA ./textures/greystone.xpm
NO ./textures/bluestone.xpm
S ./textures/barrel.xpm
F	220,100,0
C	225,30,0

11111111111111111111111111111111111111111111111111111111111111111111111111111111
10000000000000000000000000000000000010000000000000000000000000000000000000000001
100000000000000000000000000000000001 1000000000000000000000000000000000000000001
100000000000000000000000000000000001 1000000000000000000000000000000000000000001
100000000000000000000000000000000001 1000000000000000000000000000000000000000001
100000000000000001111111100000000001 1000000000000000000000000000000000000000001
100000000000000001      111111111111 1000000000000000000000000000000000000000001
100000000000000001                   1000000000000000000000000000000000000000001
100000000000000001      11111111111111000000000000000000000000000000000000000001
10000000000000000111111110000000000000000000000000000000000000000000000000000001
10000000000000000000000000000000000000000000000000000000000000000000000000000001
10000000000000000000000000000000000000000000000000000000000000000000000000000001
10000000000000000000000000000000000000N00000000000000000000000000000000000000001
10000000000000000000000000000000000000000000000000000000000000000000000000000001
10000000000000000000000000000000000000000000000000000000000000000000000000000001
10000000000000000000000000000000000000000000000000000000000000000000000000000001
10000000000000000000000000000000000000000000000000000000000000000000000000000001
10000000000000000000000000000000000000000000000000000000000000000000000000000001
10000000000000000000000000000000000000000000000000000000000000000000000000000001
10000000000000000000000000000000000000000000000000000000000000000000000000000001
10000000000000000000000000000000000000000000000000000000000000000000000000000001
10000000000000000000000000000000000000000000000000000000000000000000000000000001
10000000000000000000000000000000000000000000000000000000000000000000000000000001
10000000000000000000000000111110000000000000000000000000000000000000000000000001
100000000000000000000000001   10000000000000000000000000000000000000000000000001
100000000000000000000000001   10000000000000000000000000000000000000000000000001
100000000000000000000000001   10000000000000000000000000000000000000000000000001
111111111111111111111111111   11111111111111111111111111111111111111111111111111
