


              WE     ./textures/wood.xpm

         C 225,      255,    255

NO ./textures/bluestone.xpm

   SO          ./textures/redbrick.xpm
 EA        ./textures/greystone.xpm

S  ./textures/barrel.xpm
F  150,   150, 150

          R 1920     1080 
        111111111111111111111111111111111111111111111111111111111111111111111111
        100000000011000000000000000000000000000000000000000000000000000000000001
        100000000011000000000000000000000000000000000000000000000000000000000001
        100000000011000000000000000000000000000000000000000000000000000000000001
        100000000011000000000000000000000000000000000000000000000000000000000001
        101100000111000000200000000000000000000000000000000000000000000000000001
        100100000000000000000000111111111111111111111111111111111111111111111111
11111111101100000111000000000000200000000000000000000000002000000000000000000011
10000000001100000111011100000000000000000000000000000000000000000000000000000011
1111011111111101110000001000100000000000000000000000001110000000000000000000001
111101       101110000001111111111111111111111111111111111111111111111111101111
11110111111111011101010010001                                            101111
1100000011010101110000001000111111111111111111111111111111111111111111111101111
1000200000000000110000001000100000000000000000001111111111111111110000000000001
1000200000000000110000001000100000000000000000001111111111111111110000000000001
1000200000000000110000001000100000000000000000001111111111111111110000000000001
1000200000000000110000001000100000000000000000001111111111111111110000000000001
1000000000000000110101001000000000000000000000001111111111111111110000000002001
1100000111010101111101111001110000000000000000000000000000000000000000000000001
1100000111010101111101111001110000000000000000000000000000000000000000000000001
1100000111010101111101111001110000000000000000000000000000000000000000000000001
1100000111010101111101111001110000000000000000000000000000000000000000000000001
1100000111010101111101111001110000000000000000000000000000000000000000000000001
1100000111010101111101111001110000000000000000000000000000000000000000000000001
1100000111010101111101111001110000000000000000000000000000000000000000000000001
1100000111010101111101111001110000000000000000000000000000000000000000000000001
11110111 1110101 10111101000111111111111000000000000000000000000000011111111111
11111111 1111111 111111110011          1111111111111111111111111111111
                       110011
                       110011
111111111111111111111111100111111111111111111111111111111111111111111
1000000000000000000000000000000000200000000000000000000000200000011
1000000000000000000000000000000000000000000000000000000000000000011
1000000000000000000000000000000000000000000000000000000000000000011
10000000000000000000000000000000000000000000000000000000000000000011
10000000000000000000000000000000000000000000000000000000000000000011
10000000000000000000000000000000000000000000000000000000000000000011
100000000000000000000000000000000000000000000000000000000000000000011
11111111111000000000000000111111111111111111111111111110000000000S111
111111111111111111111111111111111111111111111111111111111111111111111111111
