
R   16000 16000

        NO           ./textures/bluestone.xpm
SO         ./textures/greystone.xpm
WE ./textures/redbrick.xpm
               EA ./textures/wood.xpm
S    ./textures/barrel.xpm
F   150,    150,    150
C 225, 255, 255

        1111111111111111111111111
        1000000000110000000000001
        1011000001110000002000001
        1001000000000000000000001
111111111011000001110000000000001
100000000011000011101111101111111
11110111111111011100000010001
11110111111111011101010010001
11000000110101011100200010001
10002000000000001100000010201
100000000200000011010100100011
11000001110101011111011110N00111
11110111 1110101 1011110102011
11111111 1111111 111111111111
