R	1000	500
SO ./textures/redbrick.xpm
WE ./textures/wood.xpm
EA ./textures/greystone.xpm
NO ./textures/bluestone.xpm
S ./textures/barrel.xpm
F	220,100,0
C	225,30,0

1111N111
