   R        1024 720
        NO           ./textures/bluestone.xpm
SO         ./textures/greystone.xpm
WE ./textures/redbrick.xpm
               EA ./textures/wood.xpm
S    ./textures/barrel.xpm
F   150,    150,    150
C 225, 255, 255

11101111
1000N001
11111111
